1111111
10C00C1
1P010E1
1111111