11111111111
10C00C10101
1P010E000C1
11111111111