1111111111111
10C00C00100C1
1P01001000111
1100111000011
10000E0C00001
1C001100C0011
1000000000101
1111111111111