1111111111111111111
1000011000001100001
1001101100011011001
1011000011100001101
1110000001000000111
1100C0000P0000C0011
1100000000000000011
111000000E000000111
1011000000000001101
1001100000000011001
1000011000001100001
1000000110110000001
1000000011100000001
1000000001000000001
1111111111111111111