1111111111111111111
1000111100011110001
1011101110111011101
1111000011100001111
1110000C01000000111
110P0000000000C0011
1100000000000000011
111000000E000000111
1111000000000001111
10111C0000000011101
1000111000001110001
1000001110111000001
1000000111110000001
1000000011100000001
1111111111111111111