1111111111111
10C00C00100C1
1P010E1000111
1100111000011
1000000C00001
1C001100C0001
1000000000001
1111111111111