1111111
10C1001
1P010E1
1111111