1111111
10C00C1
1P01E01
1111111