1111111
1000C01
1P010E1
1111111