1111111
10CE001
1P01C01
1111111